0000000000000000000000000000000000000000000000000000000111110110011111000000000000000000000011011111
0000000000000000000000000000000000000000000000000000000110011111111111100000000000000000000001111111
0000000000000000000000000000000000000000000000000000101110111111111111110000000000010000000111111111
0000000000000000000000000000000000000000000000000001111111111111111111111000000000111000000111111111
0000000000000000000000000000000000000000000000000000111111111111111111111000000000111000000111111111
0000000000000000000000000000000000000000000000000000111111111111111111111000000000101000000111111111
0000000000000000000000000000000000000000000000000000011111110001111100011100000001111111111111111111
0000000000000000000000000000000000000000000000000000011111110011111111101100000001111111111111111111
0000000000000000000000000000000000000000000000000000011111111001111111111100000000111111111111111110
0000000000000000000000000000000000000000000000000000010011111000111111111000000101111111101111111000
0000000000000000000000000000000000000000000000000000011010001000111111111000000101111111111111000000
0000000000000000000000000000000000000000000000000000001011000001111111111000111111111110011100000000
0000000000000000000000000000000000000000000000000001101011100001111111111010111000000011000000000000
0000000000000000000000000000000000000000000000000011111000110111111111111111111000000001011100000000
0000000000000000000000000000000000000000000000000011100000011111111111111111111000000001011100000000
0000000000000000000000000000000000000000000000000010000000000111111111111111100000000001011100000000
0000000000000000000000000000000000000000000000000011000000000111111111111111100000000011111000000000
0000000000000000000000000000000000000000000000000011000000000001111111111111000000000011111000000000
0000000000000000000000000000000000000000000000000011000000000001111111111110000000000111111110000000
0000000000000000000000000000000000000000000000000111000000000001110011111110000000000111111111000000
0000000000000000000000000000000000000000000111111111000000000000000001111000000000001111111101000000
0000000000000000000000000000000000000000001111111110000000000000000000001000000000001111111101000000
0000000000000000000000000000000000000000001111111100000000000000000000000000000000011011111111000000
0000000000000000000000000000000000000000001111111100000000000000000000000000000000010001111111100000
0000000000000000000000000000000000000000011111111100000000000000000000000000000000010001111111100000
0000000000000000000000000000000000000000011111111110000000000000001110100000000000111000111110000000
0000000000000000000000000000000000000000011111111000000000000000011111101111111101111000111110000000
0000000000000000000000000000000000000000011111111000000000000000011111111100000111110001110110000000
0000000000000000000000000000000000000000000011110000000000000000011111110110001111110000110000000000
0000000000000000000000000000000000000000000000110000000000000000010111011110000000000000000000000000
0000000000000000000000000010000110000000000000000000000000000000011111111111100000000000000000000000
0000000000000110000000001111000011110000000000000000000111111111101111111111100000000000000000000000
0000000111001110111000000101110111110000000000000000000111111111111111111110000000000000000000000000
0000000011101111110000001111110111110000000000000000001110111111111111001100000000000000000000000000
0000000011111111111111011111111111100000000000000000000110000111111110000000000000000000000000000000
0000000000111111111111111111111111111111000000000000001100000000111000000000000000000000000000000000
0000001111111111111111111111001000001111000000001100001100000001111100000000000000000000000000000000
0000111111111111110111111111000000000101000000001111101000001111111100000000000000000000000000000000
0001111111111111111111111111100000111011000000011111111000001110111100000000000000000000000000000000
0001111111111101111110001111110000011110000111011111111111101111111101111000000000000000000000000000
0111110111111111001101001111100000000111001111111111111111111111111111010000000000000000000000000000
0011100111111111100001111010000000000001011111111111110001011011111111111100000000000000000000000000
0000000111111111111101111011000000000001111111111111110001011100011111111000000000000000000000000000
0000000111111111111110101111000000000001111111111111110111001110001111111000000000000000000000000000
0000000001111111111110111011000000000111111111111111110000001110001111111000000000000000000000000000
0000000000001111111110111111100000000111111111111110000000000100001111110000000000000000000000000000
0000000000000001001110111111000000000011111111111111000000000111111111110000000000000000000000000000
0000000000000000000111111111000000000000111111110010000000000001010111111000000000000000000000000000
0000000000000000000111111111100000000000011111111110000000000000011111111000000000000000000000000000
0000000000000000000011011110000000000000011111111110000000000000001111000000000000000000000000000000
