0000000000000000000000000000000000000000000000000000000000000000000000111111111000000000000000000000
0000000000000000000000000000000000000000000000000000000000000000000000111111111000000000000000000000
0000000000000000000000000000000000000000000000000000000000000000000001111111001100000000000000000000
0000000000000000000000000000000000000000000000000000000000000000000001111111001100000000000000000000
0000000000000000000000000000000000000000000000000000000000000000000000111111001000000000000000000000
0000000000000000000000000000000000000000000000000000000000000000000000111111101011100000000000000000
0000000000000000000000000000000000000000000000000000000000000000000011111011111110110000000000000000
0000000000000000000000000000000000000000000000000000000000000000000011110011111111110000000000000000
0000000000000000000000000000000000000000000000000000000000000000000111111111011111110000000000000000
0000000000000000000000000000000000000000000000000000000000000000001111111111001111110000000000000000
0000000000000000000000000000000000000000000000000000000000000000111111111100001111110000000000000000
0000000000000000000000000000000000000000000000000000000000000001111111111110000011110000000000000000
0000000000000000000000000000000000000000000000000000000000000001100011111111010011100000000000000000
0000000000000000000000000000000000000000000000000000000000000000000011111111111111111000000000000000
0000000000000000000000000000000000000000000000000000000000000000000011110111101111110000000000000000
0000000000000000000000000000000000000000000000001100000000000000000011111111111111100000000000000000
0000000000000000000000000000000000000000000001111111000000000000000011111111111111100000000000000000
0000000000000000000000000000000000000000000011111111000000000000000011111111011110000000000000000000
0000000000000000000000000000000000000000000111111111100000000000111011111111111110010000000000000000
0000000000000000000000000000000000000000000111111111111100000001111111111111111111110000000000000000
0000000000000000000000000000000000000000000011111111111000000111111110111111111111110000000000000000
0000000000000000000000000000000000000000000011111011111000000000000011111111111111111100000000000000
0000000000000000000000000000000000000000000011111111111000000000000111111111111111111110000000000000
0000000000000000000000000000000000000000000000111111111000000000010111110111111111100010000000000000
0000000000000000000000000000000000000000000000001011111100000011111111001111111111110010000000000000
0000000000000000000000000000000000000000000000001111111110000111111110011111111111111110110000000000
0000000000000000000000000000000000000000000000000001111110000111111110011111111111111111111111000000
0000000000000000000000000000000000000000000000110011111110001111111111111111111111111111111111111100
0000000000000000000000000000000000000000101111111111111111111111101111111111111111111111111110001100
0000000000000000000000000000000000000000111111111111111111111111111111111111111111111111111110000110
0000000000000000000000000000000000000000011110011011111111111111111111111111111111111111111111111111
0000000000000000000000000000000000000000011110111110111111111111111111111111111111111111111111111111
0000000000000000000000000000000000000000111101111000011111111111111101011111111111111111111111111111
0000000000000000000000000000000000000000001111110000000111111111111110011100111111111111111111111111
0000000000000000000000000000000000000000001111110000000011111111111101110001111111111111111111111111
0000000000000000000000000000000000000000001011100000000011111111111111111000111111111111111111111111
0000000000000000000000000000000000000000000000000000000010011111111110011011111111111111111111111111
0000000000000000000000000000000000000000000000000000000000111111111110000111101111111111111111111111
0000000000000000000000000000000000000000000000000000000001100111111110011110001111111111111111111111
0000000000000000000000000000000000000000000000000000000001100011011111111111111111111111111111111111
0000000000000000000000000000000000000000000000000000000001110000011101111111111111111111111111111111
0000000000000000000000000000000000000000000000000000000001111000010001111111111111111111111111111111
0000000000000000000000000000000000000000000000000000000000111111110000001111111111111111111111111111
0000000000000000000000000000000000000000000000000000000001111111111000001111111111111111111111111111
0000000000000000000000000000000000000000000000000000000000111011111111111111111111111111111111111111
0000000000000000000000000000000000000000000000000000000000000111111101111111111111111111111111111111
0000000000000000000000000000000000000000000000000000000000000000111111111111111111111111111111111111
0000000000000000000000000000000000000000000000000000000000000000110011111111111111111111111111111111
0000000000000000000000000000000000000000000000000000000000000000000111111111111111111111111111111111
0000000000000000000000000000000000000000000000000000000000000000000111111111111111111111111111111111
