0000000000000000000000000000000000000000000111111111111000000000111111111111111111111111000000000000
00000000000000000000000000000000000000000000111111111110000000011E1110111111111111E11110000000000000
00000000000000000000000000000000000000000001111E1111111100000001111111111111111E11111110000000000000
00000000000000000000000000000000000000000000111111111111100000011E1111111111111111111110100000000000
0000000000000000000000000000000000000000000011111111111111011011111111111111111111110111100000000000
00000000000000000000000000000000000000000000111111111111101110111111111111111E1111110011110000000000
000000000000000000000000000000000000000001100111111E1111000111E11111E111111111111111E011110000000000
0000000000000000000000000000000000000000111100111111111111111111111000111111111111111111110000000000
000000000000000000000000000000000000000001111111E11111111111111E111110111111111111111111000000000000
0000000000000000000000000000000000000000001111111111111111E11111111111111111111111111011100000000000
000000000000000000000000000000000000000000111111111101111111111111111111111E111111011000000000000000
0000000000000000000000000000000000000000011111111111111111E1E111111E11111111110111000000000000000000
00000000000000000000000000000000000000001111111111111111110001111111111111E1111111000000000000000000
00000000000000000000000000000000000000111111111E1101111111111100111111111111111111000000000000000000
00000000000000000000000000000000000000111111111111111E1111100000111110000000011110000000000000000000
0000000000000000000000000000000000000111111111111001101111100000111110000001110010000000000000000000
0000000000000000000000000000000000000011111111111111111E10111001110000000001111100000000000000000000
000000000000000000000000000000000000011111011111E1111E1100101011110000000000100000000000000000000000
0000000000000000000000000000000000000011111E11111111111100101111111000000000100000000000000000000000
0000000000000000000000000000000000011111111111111111EE1101110011111000000011100000000000000000000000
00000000000000000000000000000000000E1111111110E11111110110110011111000000001100000000000000000000000
00000000000000000000000000000000000011111111100111E1100111111111111E00011111000000000000000000000000
0000000000000000000000000000000000001111111110011111111000110110111100011100000000000000000000000000
00000000000000000000000000000000000111111110000001011011001111E1111100111100000001111000011000000000
0000000000000000000000000111110000011001111000011110001111111111E1111110111000110110100001E000000000
00000000000000000000001111111100000111101110000011E11101101111111111100001000011111011E0011000000000
0000000000000000000011111111100011110111E010000111101000000111011E1000011111111111100011110000000000
00000000000000000001111111111100111101E11110000011101000001111111E1000011111111000000000010000000000
0000000000000000000100E11110000001111E01100000001110E10000101111000000111111111000000000110000000000
000000000000000111011001110000000111100000000000011E1100001111E1100000111111110000000001110000000000
0000000000000000111011110E00000011111111000000000011110000000001110110111111111111110001111000000000
00000000000000000011111100000001111111111100000000000000000000011111111E1111100000011001111000000000
0000000000000000001E111000000000111111100100000000000000000000011110E1111111100000011111010000000000
0000000000000000110111100000000011111110010100000000000000000001110011111E11000000011110000000000000
000000000000000111011000000000001111E1100E1110000000000000000000111011111111000000000000000000000000
00000000000000011111000000000000001111011100100011000000000000000011E1EE1110000000000000000000000000
0000000000000000011110000000000000111111110111111100000000000000000010110100000000000000000000000000
00000000000000000011111000000000E1110E11111111111000000000000000000111111100000000000000000000000000
000000000000000000110010000000E11E0101E111110001100000000000000000011E100000000000000000000000000000
0000000000000000000000110000011010011E11101110000000000000000000000000000000000000000000000000000000
000000000000000000000111000001001111E111111111000000000000000000000000000000000000000000000000000000
0000000000000000000001110000010011101111111E11000000000000000000000000000000000000000000000000000000
00000000000000000000011111E1110001101111E11111110000000000000000000000000000000000000000000000000000
00000000000000000000000000E00000001111111111EE010000000000000000000000000000000000000000000000000000
0000000000000000000000000000000000111110111111110000000000000000000000000000000000000000000000000000
0000000000000000000000000000000000011100111111110000000000000000000000000000000000000000000000000000
0000000000000000000000000000000000011000111111110000000000000000000000000000000000000000000000000000
000000000000000000000000000000000000000001E111000000000000000000000000000000000000000000000000000000
0000000000000000000000000000000000000000001000000000000000000000000000000000000000000000000000000000
0000000000000000000000000000000000000000000000000000000000000000000000000000000000000000000000000000
