0000000000000000000000000000000000000000111110000000011111100001110000000000000000000000000000000000
0000000000000000000000000000000000000001111110000000111111100111111000000000000000000000000000000000
0000000000000000000000000000000000000011111110000000111111100111111000000000000000000000000000000000
0000000000000000000000000000000000000011111111111111111111101111111000000000000000000000000000000000
0000000000000000000000000000000000000000111110100111111111101111110000000000000000000000000000000000
0000000000000000000000000000000000000000000110000111111011111111110000000000000000000000000000000000
0000000000000000000000000000000000000110000111000011101000111111111000000000000000001110000000000000
0000000000000000000000000000000000001110011111000011100000011011100000000000000000001011100000000000
0000000000000000000000000000000000001111110000000000000000010010000000000000000000001010000000000000
0000000000000000000000000000000000000100000000000000000000000010000011100000000000001110000000000000
0000000000000000000000000000000000000111111000000000000000000010000010110000100000001111000000000000
0000000000000000000000000000000000001100010000000000000000001110000110111111100001111111000000000000
0000000000000000000000000000000000000100111100000000000000001100010100110011110001111110000000000000
0000000000000000000000000000000000000000001100000000000000001111111100011011111111111100000000000000
0000000000000000000000000000000000000000001010000000000000000111111110111111111011111100000000000000
0000000000000000000000000000000000000000001111111100000000000110011000110111111111111000000000000000
0000000000000000000000000000000000000000001111111100000000000000000000110010110111001000000000000000
0000000000000000000000000000000000000000001111111000000000000000000001110011111111010000000000000000
0000000000000000000000000000000000000000111111111000000000000000000001110110111111111100000000000000
0000000000000000000000000000000000000000111110000000000000000000000111000011111111111101011100000000
0000000000000000000000000000000000000000001100000000000000000000000011000111111111111111111110000000
0000000000000000000000000000000000001101011110000000000000000000000011000001110010111110111110000000
0000000000000000000000000000000001111111111111111000000000000000000010000011110000101111111110101000
0000000000000000000000000000000011011111111111111101000000000000000110111111100001111111100111111111
0000000000000000000000000000000111001111111111111111100000000000000111111111110001111111111101111111
0000000000000000000000000000000111111111111111111111100000000000000011101110000000011111111111111111
0000000000000000000000000000000011111111111111111111100000000000000010001100000000111111101111111111
0000000000000000000000000000000001111111111111111111000000000000000000000000110001111111111111111110
0000000000000000000000000000000001111111111111111111000000000000000000000000011111111111111111111110
0000000000000000000000000000000000001100001111111100000000000000000000000000011111111111111111111111
0000000000000000000000000000000000000000001111111111000000000000000000111001111111111111111111011111
0000000000000000000000000000000000000000111111111000000000000000000000110111111111111111111111111111
0000000000000000000000000000000000000000011111111100000000000000000111110111001111111111111111111111
0000000000000000000000000000000000000001111111111100000000000000111111111011011110111111111110011111
0000000000000000000000000000000000001101111111111100000000000111111111111111111111111111111111110111
0000000000000000000000000000000000001111111111111000000000000111101111111111111111111111111111111001
0000000000000000000000000000000000001111111101101000000000001111111101111111111111111111111110111100
0000000000000000000000000000000000000111111111100000000000001111111101111111111111111111111000010000
0000000000000000000000000000000000000011110000000000000000001111111111111111101111111111111111110000
0000000000000000000000000000000000001111111000000000000000000111110011111111111111111111111101110000
0000000000000000000000000000000000001111111000000000000000000111110011111111111111110111111111100000
0000000000000000000000000000000000001111100000000000000000000111111111111111111111111111111001100000
0000000000000000000000000000000000000011000000000000000000011111111111111111111111110111110001111000
0000000000000000000000000000000000000001000000000000000000111100111111111111111111111111111001011100
0000000000000000000000000000000000000000000000000000000000011100111111111111111110011111111001111110
0000000000000000000000000000000000000000000000000000000001111111111111111111111000000011110000001110
0000000000000000000000000000000000000000000000000000000001111111111100111111110000000011011100011110
0000000000000000000000000000000000000000000000000000000001111011111100111111100000000011000111011100
0000000000000000000000000000000000000000000000000000000011111111111111111111000000000000000001110100
0000000000000000000000000000000000000000000000000000000011111111111111111111110000000000000000000100
