0000000000000000000000000000000000000000000000000000000000000000000000000011111100000000101111111111
000000000000000000000000000000000000000000000000000000000000000000000000000110100000000011111110E111
0000000000000000000000000000000000000000000000000000000000000000000000000001111001100000111E11111111
000000000000000000000000000000000000000000000000000000000000000000000000001E111001111E00011111111111
0000000000000000000000000000000000000000000000000000000000000000000000000111111101111111111111E1E111
000000000000000000000000000000000000000000000000000000000000000000000000111E111101111111111110111111
0000000000000000000000000000000000000000000000000000000000000000000000001111111000111111111110111111
0000000000000000000000000000000000000000000000000000000000000000000000111111111111111100111111111111
00000000000000000000000000000000000000000000000000000000000000000000001111E1111101111100111111111111
000000000000000000000000000000000000000000000000000000000000111111000111111111110111001E101111011111
0000000000000000000000000000000000000000000000000000000000000111110001110101111111E11010001111011111
000000000000000000000000000000000000000000000000000000000000E1111110001101111111111E1110000011101111
00000000000000000000000000000000000000000000000000000000000000111110001E1111111111111111100011111111
0000000000000000000000000000000000000000000000000000000000000101111001111111E11111111110110110001111
00000000000000000000000000000000000000000000000000000000E111111111100111E11111111111E110010100001111
0000000000000000000000000000000000000000000000000000001111001111111011111E110011111E1E11011100001000
0000000000000000000000000000000000000000000000000000011111001111111111111111111111111110000000011000
000000000000000000000000000000000000000000000000100000111111111E11111111111111111011111000001E111000
00000000000000000000000000000000000000000000001111000110111111111111111010111110101111100000100E0000
0000000000000000000000000000000000000000000001100100001111111111101E11E00111111111111E11001110000000
00000000000000000000000000000000000000001111E110011110110111111000000100001100111111E11111E000000000
00000000000000000000000000000000000000001111E110011E111101111100000001000111111E100E1111011000000000
000000000000000000000000000000000000000001E111100111111101111100000011E11111111110111011000000000000
00000000000000000000000000000000000000000E1111111111111000111110010111111110111111101110000001110000
0000000000000000000000000000000000000000111E101111111111111111101111111111001110E110E111000001100000
00000000000000000000000000000000000000111111111111111111111111111111111111001000E11111E1000001100000
000000000000000000000000000000000000001111111E11111E1111111111111111E1111101100011111111000000110000
000000000000000000000000000000000000000111111111E1111111111111111111111111111000011E1110000111111000
0000000000000000000000000000000000000011111110001111111101111111111111111111000000101000011111111100
000000000000000000000000000000000000001111110000101110011111001011111110111100001111111101111E111111
000000000000000000000000000000000000000E1111110000000000000000011111110111100010111111E1001111111111
00000000000000000000000000000000000000001011011100000000000000011110111111101011111111111E1111111E11
000000000000000000000000000000000000000011111111100000000000000E11111111111111111111111111111111111E
000000000000000000000000000000000000000011000000000000000000000000001111000111111E111111111111111111
00000000000000000000000000000000000000000000000000000000000000000000000000111111E1111111111111111111
00000000000000000000000000000000000000000000000000000000000000000000000001101111E1111111E11111111110
0000000000000000000000000000000000000000000000000000000000000000000000000111110111111111111111111100
000000000000000000000000000000000000000000000000000000000000000000000000011011000E111111111111E11001
0000000000000000000000000000000000000000000000000000000000000000000000000011111111111111111111111111
000000000000000000000000000000000000000000000000000000000000000000000000001E00111111111111E111111111
000000000000000000000000000000000000000000000000000000000000000000000000001111111111E111111111111111
0000000000000000000000000000000000000000000000000000000000000000000000000000000111111E11E11111111111
0000000000000000000000000000000000000000000000000000000000000000000000000000001111E111E1111111111111
00000000000000000000000000000000000000000000000000000000000000000000000000000011100111E1111111111111
0000000000000000000000000000000000000000000000000000000000000000000000000000011100001111111111111E11
00000000000000000000000000000000000000000000000000000000000000000000000000000110001111111111111E1111
0000000000000000000000000000000000000000000000000000000000000000000000000000000001111111111111111111
0000000000000000000000000000000000000000000000000000000000000000000000000000000001111111E111111E1111
000000000000000000000000000000000000000000000000000000000000000000000000000000001E1111111111E1111111
00000000000000000000000000000000000000000000000000000000000000000000000000000001111E1111111111111E1E
