0000000000000000000000000000000000000000000000000000000000000000000011111111100110000000000000000000
0000000000000000000000000000000000000000000000000000000000000000000111111111111111000000000000000000
0000000000000000000000000000000000000000000000000000000000000000011111111111011111000000000000000000
0000000000000000000000000000000000000000000000000000000000000000111111111111110011000000000000000000
0000000000000000000000000000000000000000000000000000000000000000011111111111110111000000000000000000
0000000000000000000000000000000000000000000000000000000000000111111111111101111111000000000000000000
0000000000000000000000000000000000000000000000000000000000000111111111111111111111110000000000000000
0000000000000000000000000000000000000000000000000000000000000011101111111111111111110000000000000000
0000000000000000000000000000000000000000000000000000000000011111111111111111111111100000000000000000
0000000000000000000000000000000000000000000000000000000000010111111111111111111111111000000000000000
0000000000000000000000000000000000000000000000000000000000111110011111111111111111111000000000000000
0000000000000000000000000000000000000000000000000000000000111100101111111111011110100000000000000000
0000000000000000000000000000000000000000000010000000000000111100111111111101110100111000000000000000
0000000000000000000000000000000000000000000110000000000000001111110111111111010000001100000000000000
0000000000000000000000000000000000000000000110000000000111111111111111111110000000001100000000000000
0000000000000000000000000000000000000000000111000000001111111111111111111110011000101100000000000000
0000000000000000000000000000000000000000001111100000001111111111111111111110011000111100000000000000
0000000000000000000000000000000000000000001011100000111111111111111111111110011111111110000000000000
0000000000000000000000000000000000000000001111111000111101111111111101111111111111111111000000000000
0000000000000000000000000000000000000000000111110000111101111111111111101111111111111111100000000000
0000000000000000000000000000000000000000001101111010011111111111111111001111011011111111000000000000
0000000000000000000000000000000000000000001111011110011111111111111111000000011111111111000000000000
0000000000000000000000000000000000000000000011011011111111111111111111110000011101111111000000000000
0000000000000000000000000000000000000000000001001000001111111111111111111000011111111110000000000000
0000000000000000000000000000000000000000000000000000001111111111111111111000111111111111100000000000
0000000000000000000000000000000000000000000000000011101111110101111111111100111111011111110000000000
0000000000000000000000000000000000000000000000000001111111111111111111111111111111111111100000000000
0000000000000000000000000000000000000000000000000001111111111111111110111111111111111111100000000000
0000000000000000000000000000000000000000000000000000111111111111111110111111111111010000000000000000
0000000000000000000000000000000000000000000000000000101111111111111111111111111111000000000000000000
0000000000000000000000000000000000000000000000000001111111111111111111111111111111000000000000000000
0000000000000000000000000000000000000000000000000000001111111111111111111111111110000000000000000000
0000000000000000000000000000000000000000000000000000001111111111111111111111111111100000000000000000
0000000000000000000000000000000000000000000000000000011111111111111111111111111111100000000000000000
0000000000000000000000000000000000000000000000000000000010111111111111111111111111100000000000000000
0000000000000000000000000000000000000000000000000000000111111100111111111111111111100000000000000000
0000000000000000000000000000000000000000000000000000001111111111111111111111111111100000000000000000
0000000000000000000000000000000000000000000000000000001111111111111111111111111111110000000000000000
0000000000000000000000000000000000000000000011110000001111111110111111111111111111110000000000000000
0000000000000000000000000000000000000000000111100001111111111110111111111111111111110000000000000000
0000000000000000000000000000000000000000000111101000111111111111111110111111111111110000000000000000
0000000000000000000000000000000000000000011111111100111111111111011110111111111111110000000000000000
0000000000000000000000000000000000000000111111111001111111111111011111100111111111111100000000000000
0000000000000000000000000000000000000000111111111111111111111111111110001111111111111100000000000000
0000000000000000000000000000000000000001111100111111111111111111111110011111111111110000000000000000
0000000000000000000000000000000000000000111001111011111111111111111111011111111111111000000000000000
0000000000000000000000000000000000000000111111111111111111111111111111111111101111111000000000000000
0000000000000000000000000000000000000000111111111111111111111011111111111111111111110000000000000000
0000000000000000000000000000000000000000011110001001111111111011111111001011111001110000000000000000
0000000000000000000000000000000000000000000110001000011111100011111111111001111001100000000000000000
