00000000000000000000000000000000000000000000001E111111111111011110E111110011001110000000000000000000
000000000000000000000000000000000000000000001111EEE1111111111111111111111111111111100000000000000000
0000000000000000000000000000000000000000000001111111E11111E11111110E111111E0111111100000000000000000
0000000000000000000000000000000000000000000001111111111111E11111111E01111111E11111110000000000000000
00000000000000000000000000000000000000000000000001111111111111111111111E1111111111111000000000000000
000000000000000000000000000000000000000000000000011E11E1111111111E1111111111111111111000000000000000
00000000000000000000000000000000000000000000000001111111111111E1011111111111111111001000000000000000
0000000000000000000000000000000000000000000011100011111111111111001111111111111111000000000000000000
0000000000000000000000000000000000000011EE1111E00011111111111110000111100111111111000000000000000000
0000000000000000000000000000000000000111101111E001111111111E11E1000101000011111100000000000000000000
0000000000000000000000000000000000000111011111111111111111111111000100000001111100000000000000000000
00000000000000000000000000000000000001111111111111000011111E11100001110000001E1E00000000000000000000
0000000000000000000000000000000000111111111111110111111111111100000011000000000000000000000000000000
000000000000000000000000000001100011111110011111111111111111111E111110000000000000000000000000000000
0000000000000000000000000010011000011111100111111111111101110110000000000000000000000000000000000000
0000000000000000000000001111111100011111110011111111111001110100000000000000000000000000000000000000
0000000000000000000000011001110111011001111111111101000000011100000000000000000000000000000000000000
00000000000000000000011110000001111111111E11111E111111000000E000000000000000000000000000000000000000
0000000000000000001111E000001101111011111011E1111111110000000000000000000000000000000000000000000000
000000000000000000111111000011E11110111111111111E111111000000000000000000000000000000000000000000000
000000000000000000101111000111011111101101111111111111E100000000000000000000000000000000000000000000
000000000000000001101110000E1100111101111011E11111E1100000000000000000000000000000000000000000000000
000000000000000111100100000111000111001111E111111111111100111000000000000000000000000000000000000000
0000000000000011111000000001110000110011111111E111111E0111111000000000000000000000000000000000000000
000000000000011111000000000111000000000100001111111E111100001111110000000000000000000000000000000000
00000000000000000111100000010000000000110000000111111111000E1111110111000000000000000000000000000000
00000000000000000110111100111000000000000000000E1E1111000000111E1111E1000000000000000000000000000000
0000000000000000010000111110000000000000000000001111111000000111001111010000000000000000000000000000
0000000000000000000000000110000000000000000000000011111011000111000111110000000000000000000000000000
000000000000000000000000000000000000000000000000001111111E0000E1000000111000000000000000000000000000
0000000000000000000000000000000000000000011110110000111011E00011000000100000000000000000000000000000
0000000000000000000000000000000000000000011110111100011111111010000000100000000000000000000000000000
00000000000000000000000000000000000000111111111111E1011111011000000000110000000000000000000000000000
00000000000000000000000000000000000000111111E1111111111E11E00000000000011110000000000000000000000000
00000000000000000000000000000000000000111111111111111111E1100010000000001011000000000000000000000000
0000000000000000000000000000000000000011111111111111001111110010000000001110000000000000000000000000
0000000000000000000000000000000000000011111111111111101111110111000000001100000000000000000000000000
0000000000000000000000000000000000000011111111111E11001000010111000011111000000000000000000000000000
000000000000000000000000000000000000011111111111E101110000000111110011111011000000000000000000000000
00000000000000000000000000000000000011111111E1111111110000000011E10110111111E00000000000000000000000
00000000000000000000000000000000000111111111111111101110000000110111111111E1001000000000000000000000
00000000000000000000000000000000000111111111111111111110000000110EE111E01111111000011000000000000000
0000000000000000000000000000000000111111111111111111111100000011001100001010E11110011000000000000000
000000000000000000000000000000000011111101111111111111111000111110110000001010E111111E00000000000000
00000000000000000000000000000000001111100111E11111111111111111111000000000111111100001E0000000000000
0000000000000000000000000000000000111110111111111111111111111111111000000001110011101110000000000000
00000000000000000000000000000000011111E1111111111111111011011111111000000000111111110110000000000000
00000000000000000000000000000000011111111111111E1111111110011111111000000000000001E10110000000000000
0000000000000000000000000000000001111111110111111111E11100000111111000000000000000110111000000000000
00000000000000000000000000000000011E1111111E111111E111100000011E1E0000000000000000111111000000000000
