1111110001111110110111111111011111100000000000000000000000000000000000000000000000000000000000000000
1111111111111000111111111111111111111000000000000000000000000000000000000000000000000000000000000000
1111111111111100011111111111111111111111000000000000000000000000000000000000000000000000000000000000
0111111111111100111111111111110011111111000000000000000000000000000000000000000000000000000000000000
1111111000011100111100111111111111110110000000000000000000000000000000000000000000000000000000000000
0101111000000111111111111111111111111110000000000000000000000000000000000000000000000000000000000000
0111111111111111111111111111111111110000000000000000000000000000000000000000000000000000000000000000
1111100111111111111111111111111011111000000000000000000000000000000000000000000000000000000000000000
1111111111111111111111111111111111111000000000011100000000000000000000000000000000000000000000000000
1111111111111111111111111111111111111101111001111111000000000000000000000000000000000000000000000000
1111111111111111111111111111111111111111101111011111100000000000000000000000000000000000000000000000
1111111111111111111111111111111111110000000111000101111000000000000000000000000000000000000000000000
1111111111111111111111111111111111110000000000000101111110000000000000000000000000000000000000000000
1111111011111111111111111111111111111000000000000111110100000000000000000000000000000000000000000000
1111101111111111111111111111111111111000000000000111111100000000000000000000000000000000000000000000
1101001111111111111111111111111111111011100000000001110000000000000000000000000000000000000000000000
1101111101111111111111111111111111111011111100000111100000000000000000000000000000000000000000000000
0111010111111111111111111111111111111110000100001110000000000000000000000000000000000000000000000000
0111111110111111111111111111111111111010000111111100000000000000000000000000000000000000000000000000
0011111111111111111111111111111111111000000000111100000000000000000000000000000000000000000000000000
0111111111111111111111111111111101110000000000111110000000000000000000000000000000000000000000000000
0111111011111111111111111111111111111110000000010000000000000000000000000000000000000000000000000000
1111111111111111111111111111111111111110000000010000000000000000000000000000000000000000000000000000
1111111111111111111111111111111111111110000001110000000000000000000000000000000000000000000000000000
1111111111111111111111111111111111111111000001000000000000000000000000000000000000000000000000000000
1111111110111111111111111111111111111011000001000000000000000000000000000000000000000000000000000000
1111111111111111111111111111111111111100000000000000000000000000000000000000000000000000000000000000
1111111111111111111011111111111111010100000000000000000000000000000000000000000000000000000000000000
1111111111111111111111111111111101000110000000000000000000000000000000000000000000000000000000000000
1111111111111111101111111111111110000010000000000000000000000000000000000000000000000000000000000000
1111111101110010111111111111111111000000000000000000000000000000000000000000000000000000000000000000
1111111111000111111111111111111111100000000000000000000000000000000000000000000000000000000000000000
1111111111011111111111111111111111110000000000000000000000000000000000000000000000000000000000000000
0011110111111111111111111111111111110000000000000000000000000000000000000000000000000000000000000000
1110100001111111111111111111111111111000000000000000000000000000000000000000000000000000000000000000
1111111000111011101111111111111111111100000000000000000000000000000000000000000000000000000000000000
1111111000111111111111111111111111110000000000000000000000000000000000000000000000000000000000000000
1111111111111111111111111111111111111000000000000000000000000000000000000000000000000000000000000000
1111111111111111111111111111111111111000000000000000000000000000000000000000000000000000000000000000
1111111011111111111111111111111111110000000000000000000000000000000000000000000000000000000000000000
