000000000000000000000000000000011111111111100010111111111111E000000000000000000000000000000000000000
000000000000000000000000000000011111111E111000101111111111111000000000000000000000000000000000000000
0000000000000000000000000000001111001111111101111111111110100000000000000000000000000000000000E11100
0000000000000000000000000000000011001111111111111111111111100000000000000000000000000000000001111111
0000000000000000000000000000000000001111111101111111111111000000000000000000000000000000000011111111
0000000000000000000000000000000000000110011111111111111111000000000000000000000000000000000111111111
0000000000000000000000000000000000000000000011110011111110000000000000000000000000000000011E11111111
0000000000000000000000000000000000000000000011111001111000000000000000000000000000000000011111E11111
00000000000000000000000000000000000000000000011111111111000000000000000000000000000000000111E111111E
00000000000000000000000000000000001E1111000011111E1011000000000000000000000000000000000001101111E1E1
0000000000000000000000000000000000111101111111111111100000000000000000000000000000000000000011EE1111
0000000000000000000000000000000000011001110111111111000000000000000000000000000000000000001111111111
0000000000000000000000000000000111111000000111111E11000000000000000000000000000000000000011111111111
0000000000000000000000000000000111E10000001111111111100000000000000000000000000000000000011111111111
00000000000000000000000000000011111100000E1111111100110000000000000000000000000000000000110111011111
0000000000000000000000000000011110110000000101101000010000000000000000000000000000010011111111111111
000000000000000000000111111111100000000000010E11110001100000000000000000000000000011111E111111111111
0000000000000001111111001001110000000000000111E00111111000000000000000000000000000111111111111111111
000000000000011111100000000000000000000110011000000000000000000000000000000000110011111111E111111111
00000000000001111100000000000000000011111111111001110000000000000000000000000011111111111E1111111111
0000000001000011110000000000000011111111100000100011011100011100000111100000011111111111110111111111
000000001110001111111000000000001111E111111000110011111101111100111E111000000011E111111111E111111111
0000000011111111111110000000000000001E111010000111111001110001111000011000000001111111111111111111E1
0000000111110011111100000000001E11001111001000011110011111000000000001100000011111111111111111111111
000000111111011111110000000001100100111000111001110011101000000001100E1000000011E0011111111111111111
00001110011110001111000000000101111111100011110101100000000000001E11E100000000011111111111111E1111E1
000011111111101111100000000011111E111100001111110000000000000000111111000000000111111111111111111110
00000111111100011111100000011111101111000001111110000000000000001111111110000E1E1E11E11111111EE1E110
0000011111110001E111100000011111100111000011101110000000000000111111E11110000111111111111111E1110100
0000011E1110000000000000000110000000000000011011E0000000000000111111111110001111111E1111111000011111
0000011111100000000000000101100000000000000000E110000000000011111111110111001E1111111111111000001100
0000111111100000000000000111000000000000000000011000000000001100111E11111111101111111111111000000100
0001110111000010010000000100000000000000000000000000000000001101111111111E01101111011111110000000000
0000110101000111110000000E00000000000000000000000000000000000111111001111100111101111E10100000000000
00011E100000011111000000010000000000000000000000000000000000000E100000000000001100011111110000000000
0000011000001111E1E101101110000000000000000000000000000000000000000000000000E11111000101111000000000
0000011111100011111111111010000000000000000000000000000000000000000000000000111110001111000000000000
0000011010000011111001000011000000000000000000000000000000000000000000000000111110000000000000000000
000000001110111EE01011000001000000000000000000000000000000000000000000000001111111100000000000000000
00000001E1E1111111E001001111000000000000000000000000000000000000000000000001111110110000000000000000
0000000011100111110001001100000000000000000000000000000000000000000000000111111111110000000000000000
000000111110111100000101110000000000000000000000000000000000000000000000010E111110000000000000000000
000011111111111100000111110000000000000000000000000000000000000000000000010E111000000000000000000000
000000000011111E000000110100000000000000000000000000000000000000000000000111011100000000000000000000
0000000000011111000000000000000000000000000000000000000000000000000000000E11001000000000000000000000
0000000000011111100000000000000000000000000000000000000000000000000000000000000000000000000000000000
0000000000011111100000000000000000000000000000000000000000000000000000000000000000000000000000000000
000000000000111E100000000000000000000000000000000000000000000000000000000000000000000000000000000000
0000000000000111000000000000000000000000000000000000000000000000000000000000000000000000000000000000
0000000000000000000000000000000000000000000000000000000000000000000000000000000000000000000000000000
