0000000000000000000000000000000111111111111111110011000000000000000000000000000000000000000000000000
0000000000000000000000001110110111111111111111111111100110000000000000000000000000000000000000000000
0000000000000000000000001110111111101111111111111111111110000000000000000000000000000000000000000000
0000000000000000000000011011111011111111111111111111111011100000000000000000000000000000000000000000
0000000000000000000100010011111111111111111110111111110000100000000000000000000000000000000000000000
0000000000000000001111010010111111011100000101111111110000100000000000000000000000000000000000000000
0000001100000111100101110000000111111100011111111111111111100000000000000000000000000000000000000000
1100001111111101111100000000000110111000111111111001111100100000000000000000000000000000000000000000
1110000111111100110000000000001111111011111111111101111100000000000000000000000000000000000000000000
1110001111000000010000000000000001111110100111111101111100000000000000000000000000000000000000000000
1101101111000000000000000000000011110000000111111111111000000000000000000000000000000000000000000000
1111101111000000000000000000000011110000001111111111110000000000000000000000000000000000000000000000
1111111111100000000000000000001101110000111111011111100000000000000000000000000000000000000000000000
1111000010000000000000000000011111110000011111011110101111100000000000000000000000000000000000000000
1110010000000000000000000000011111100000011111011110111111100000000000000000000000000000000000000000
1111110000000000000000001111111111110000001110111111111111000000000000000000000000000000000000000000
1111111000000000000000001111111111111000011111111101111101000000000000000000000000000000000000000000
1111111000000000000000000111111111111101111101111111101111000000000000000000000000000000000000000000
1111111110000000000000000000011111111011111111111111111111000000000000000000000000000000000000000000
1111111111000000000000000000011110100011111111111111100111000000000000000000000000000000000000000000
1111111111110000000000000000001110000001111111111111100111000000000000000000000000000000000000000000
1111111101111000000000000000001011110000111011111111111110000000000000000000000000000000000000000000
1111111110111000000000000000001111111100011011111111111110000000000000000000000000000000000000000000
1111111010111000000000000000000011110111001110111111111000000000000000000000000000000000000000000000
1111100011100000000000000000000001111111011110110011100000000000000000000000000000000000000000000000
1100100011000000000000000000000000111111011111111110100000000000000000000000000000000000000000000000
0001100001110000000000000000000000001100011111001100100000000000000000000000000000000000000000000000
0011110011111000000000000000000000001110111111001100000000000000000000000000000000000000000000000000
0011111111111000000000000000000000000011111111100100000000000000000000000000000000000000000000000000
0001010111111100000000000000000000000011101111100100000000000000000000000000000000000000000000000000
0011000011111110000000000000000000000111111110111000000000000000000000000000000000000000000000000000
0010000001111111000000000000000000001100111111100000000000000000000000000000000000000000000000000000
0110000001111111000000000000000000001111100011000000000000000000000000000000000000000000000000000000
0110011001110101000000000000000000011111111111110000000000000000000000000000000000000000000000000000
1111111111111100000000000000001111111111101111110000000000000000000000000000000000000000000000000000
1111111111101100000011110000001111111111111111100000000000000000000000000000000000000000000000000000
1111111101001110000011111000001011111111111111111000000000000000000000000000000000000000000000000000
1111111100000011100001001111001111111111111111110000000000000000000000000000000000000000000000000000
0011111100000011110111011111100111110111111111111000000000000000000000000000000000000000000000000000
0000111111000111111110011111111111111111111111111100000000000000000000000000000000000000000000000000
0000000011111111110000101101111111111111111111111110000000000000000000000000000000000000000000000000
0000000011100111110011111111111111111111111111100000000000000000000000000000000000000000000000000000
0000011111111111111111101111111111111111111111100000000000000000000000000000000000000000000000000000
0000111111101111111111101110111111111111111111000000000000000000000000000000000000000000000000000000
0001111111111110011110111110111111111111001110000000000000000000000000000000000000000000000000000000
0001111111111110010001110011111111011111011100000000000000000000000000000000000000000000000000000000
0011111111101111011111111111111111011111111110000000000000000000000000000000000000000000000000000000
0001111111110111011111111111111111001111111110000000000000000000000000000000000000000000000000000000
0001111111011111111111111111111000001111111111000000000000000000000000000000000000000000000000000000
0000011110001100001111111111010000000001111111000000000000000000000000000000000000000000000000000000
