0000000000000000000000000000000000000000000000000000000000000000000000000000000000000000000000000000
0000000000000000000000000000000000000000000000000000000000000000000000000000000000000000000000000000
0000000000000000000000000000000000000000000000000000000000000000000000000000000000000000000000000000
0000000000000000000000000000000000000000000000000000000000000000000000000000000000000000000000000000
0000000000000000000000000000000000000000000000000000000000000000000000000000000000000000000000000000
0000000000000000000000000000000000000000000000000000000000000000000000000000000000000000000000000000
0000000000000000000000000000000000000000000000000000000000000000000000000000000000000000000000000000
0000000000000000000000000000000000000000000000000000000000000000000000000000000000000000000000000000
0000000000000000000000000000000000000000000000000000000000000000000000000000000000000000000000000000
0000000000000000000000000000000000000000000000000000000000000000000000000000000000000000000000000000
0000000000000000000000000000000000000000000000000000000000000000000000000000000000000000000000000000
0000000000000000000000000000000000000000000000000000000000000000000010000000000000000000000000000000
0000000000000000000000000000000000000000000000000000000000000000111111000000000000000000000000000000
0000000000000000000000000000000000001110000000000000000001100000110001110000000000000000000000000000
0000000000000000000000000000000010001110011000000000000001100000100011011000000000000000000000000000
0000000000000000000000000000011111111111110000000000000001111100111011001100000000000000000000000000
0000000000000000000000000001111101111111110000001000011001111111111001001100000000000000000000000000
0000000000000000000000000001111001111111110000001111111001101111111111111100000000000000000000000000
0000000000000000000000001111111000001111110000111111111001111111111010001100000000000000000000000000
0000000000000000000000000111111000001111111000111111111111111111111110000000000000000000000000000000
0000000000000000000000000111111000001111111111111110011000011111111111100011111000000000000000000000
0000000000000000000000000011111000000011111111111111111000001111111111101110111000000000000000000000
0000000000000000000000000001100000001111111110111111111000011111111111111110110111001100000000000000
0000000000000000000000000001111000001111100111111111001110001111111111110111111111111100000000000000
0000000000000000000000000000010000001111110111111111011111011111111111111111111111101100000000000000
0000000000000000000000000000010000001111110011111111001111111111111111111111111110101100000000000000
0000000000000000000000000000000000011111111011111110000111111111111111111111111111101100000000000000
0000000000000000000000000000000001111111111111111110000111111111111111111001111111111100000000000000
0000000000000000000000000000000011111111111111111111111110111111111111111111111111011110000000000000
0000000000000000000000000000000111111111111111111111111111111111111111111111111111110111000000000000
0000000000000000000000000000001111111111111110101111111111111111111111111111111111111100000000000000
0000000000000000000000000000001111111111111110011111111111111001111111111111111111111100000000000000
0000000000000000000000000000111111111111111100001111111111111111111111111111111111100100000000000000
0000000000000000000000000000011111111111111000000110111111111011111111001111111111110110000100000000
0000000000000000000000000000000011111110110000000111111111111001111111100110111111111111110100000000
0000000000000000000000000000000001111111111000000111111111111110111111111111110111111001111111000000
0000000000000000000000000000000000011111000000000011111111110111110111111111111111111011111111100000
0000000000000000000000000000000000011111001000000011111111110100011111111111111111111111111111000000
0000000000000000000000000000000000001111011000000010111111110111011111111111111111111111111111000000
0000000000000000000000000000000000011111111110111111111111110110111111111111110111111111100111100000
0000000000000000000000000000000000111110011111111111111111000111111111111111111111111110111111100000
0000000000000000000000000000000000011110001111111101111111000001111111111111111111111110111111000000
0000000000000000000000000000000000011100001111111100111110000000111111111111110011011111111111100000
0000000000000000000000000000000000000000001111111100111110000000111111111111110000000000000111000000
0000000000000000000000000000000000000000011111111111110110000000110111111111111100000000000101100000
0000000000000000000000000000000000000000111111111111110010000001110111111111111100000000000011000000
0000000000000000000000000000000000000000111111111111111110000001111111111000111100000000000000000000
0000000000000000000000000000000000000000111111111111111100000001111111111100110000000000000000000000
0000000000000000000000000000000000000000000111111111111000001111111111111000000000000000000000000000
0000000000000000000000000000000000000000000111111111110000000011111111111000000000000000000000000000
