1111000000001100001110000000000000000000000000000000000000000000000000000000000000000000000000000000
1111000000011110001111111000000000000000000000000000000000000000000000000000000000000000000000000000
1111100000111111000110111000000000000000000000010000000000000000000000000000000000000000000000000000
1111110001111111001111111011000000000000000000011100000000000000000000000000000000000000000000000000
1111111100111001111111011111100000000000000000110100000000000000000000000000000000000000000000000000
1111111000111101111111011111100000000000000000110110000000000000000000000000000000000000000000000000
1111111101111111111111111111110000000000011000010110000000000000000000000000000000000000000000000000
1111111111111111111111011111100000000000111010011100000000000000000000000000000000000000000000000000
1111111111111111111111111111100000000000111111111000000000000000000000000000000000000000000000000000
1101111111111111110001101111000000000000111111110000000000000000000000000000000000000000000000000000
1111111111111111110001111011000000000000101111111100000000000000000000000000000000000000000000000000
1111111111111111111111111111100000000000100011100100000000000000000000000000000000000000000000000000
1111111111111111111111110111100000000000110000001100000000000000000000000000000000000000000000000000
1111111111111111111111111111100110000000100001001000000000000000000000000000000000000000000000000000
1111111111111111111111111111101111100011100011111000000000000000000000000000000000000000000000000000
1111111111111111111111111111100111100111000001000001100000000000000000000000000000000000000000000000
1111111111111111111111111111110111111110000001000011100000000000000000000000000000000000000000000000
1111111111111110111111111111111111111111000011111111100000000000000000000000000000000000000000000000
1111111111111111111111111111111111111111000011111111111110000000000000000000000000000000000000000000
1111111111111111101111111111111111100011000000001111100110000000000000000000000000000000000000000000
1111111111111111111111111111111111110011000000000011100010000000000000000000000000000000000000000000
1111111111111111111111111111111111111111110000000001110011110000000000000000000000000000000000000000
1111111111111111111111111111111111111111111100000000110011010000000000000000000000000000000000000000
1111111111111000111001110011111111111101111100000000111100110100000000000000000000000000000000000000
1111111111111010111001111111101111111111111000000000101110111110000000000000000000000000000000000000
1111111111111111111111111110011111111111111000000000101111111110000000000000000000000000000000000000
1111111111111111111111111100011111001101111110000000100111111110000000000000000000000000000000000000
1111111111111111111111111100001111111111110110000000111111111111100000000000000000000000000000000000
1111111111111111111111111111000011111111100100000000001111111111000000000000000000000000000000000000
1111111111111111111111111111000000011111110110000000001111111111110000000000000000000000000000000000
1111111111111111111111100110000000011111101111100000001111111111100000000000000000000000000000000000
1111111111111111111111111110000000110111011111111100101011111101100000000000000000000000000000000000
1111111111111111111111111110000000000111111100011101111011111100000000000000000000000000000000000000
1111111111111111111111111000000000000000011000011111110001111110000000000000000000000000000000000000
1111111111111111111111111000000000000011110000010001110000111110000000000000000000000000000000000000
1111111111111111111111111000000000000011110000000000100000111110000000000000000000000000000000000000
1111111111111111111111110000000000000011100000000000000000011110000000000000000000000000000000000000
1111111111111111111111111000000000000000000000000000000000000100000000000000000000000000000000000000
1111111111111111111111011000000000000000000000000000000000000111000000000000000000000000000000000000
1111111111111111111100000000000000000000000000000000000000000100000000000000000000000000000000000000
